30 30 Pockets
XXXXXXXXXXXXXXXXXXXXXXXXXXXXXX
X                            X
X    X XX      XXXXXXXX      X
X   X X  X     X      X      X
X  X     X     XXX  XXX xxxxxX
X        X       X  X        X
X        XXXXXXXXX  XXXXXXX  X
XXXXXXXXX                    X
X          xxxxxxxxxxxxxxxxxxx
X  xxxxxxxx       x          x
X  x           x      x  x   x
X  x  x    x                 x
X  x              x   x  x   x
X  x     x  x     x    x     x
X  x  x           x          x
X  x    * x          x   xxx x
X  x  x     x      x   x x   x
X  x         xx   x  xx  x xxx
X  x    x         x  x  x    x
X  x     x     x  x  x x  x  x
X  x       x      x  x x x   x
X  x              x  x x x xxx
X  x x   x   x    x  x x x   x
X  x        x x  x x x x x   x
X  x   x   xx  x x x x x x   x
X  x        x  x x x x x x   x
X  x     x xx  x x x x x x   x
X  xxxxxxxx    xxx x x x x 0 x
X           x        x   x   x
XXXXXXXXXXXXXXXXXXXXXXXXXXXXXX